16
16
256
10 6
5 9

1 1 1 1 1 1 1 1 1 0 0 0 0 0 0 0 
0 1 0 1 0 0 0 0 1 1 0 1 0 0 1 0 
0 1 0 1 0 1 1 0 1 0 0 1 1 1 1 0 
0 0 0 0 0 1 3 0 1 0 1 1 0 0 1 0 
0 1 1 1 1 1 1 1 1 0 0 1 1 0 0 0 
0 0 0 0 0 0 0 0 1 0 1 1 0 0 1 0 
0 1 0 1 0 1 1 1 1 0 2 1 1 0 1 0 
1 1 1 1 0 1 0 0 1 1 1 1 1 1 1 0 
0 0 0 0 0 1 0 0 0 1 0 0 0 0 1 0 
1 1 1 1 0 0 0 1 0 1 0 1 0 0 0 0 
0 0 0 0 0 0 1 1 0 1 0 1 1 1 1 0 
0 1 1 1 1 1 1 0 0 1 0 1 0 1 0 0 
0 1 0 0 1 0 1 1 1 1 0 1 0 0 0 0 
0 1 0 0 1 0 1 0 0 1 1 1 1 1 1 0 
0 1 1 0 1 0 1 1 0 0 0 1 0 0 1 0 
0 0 0 0 0 0 0 0 0 0 0 0 0 0 0 0 
