8
8
64
0 2
4 4

0 0 0 0 0 0 0 0 
0 1 1 0 1 1 0 1 
2 1 0 0 0 1 0 0 
1 1 0 1 1 1 1 1 
0 1 0 1 3 0 0 0 
0 1 0 1 1 0 1 1 
0 1 0 1 0 0 1 0 
0 0 0 0 0 0 0 0 
