8
8
64
6 4
2 0

0 0 3 1 0 0 0 0 
0 1 1 1 1 1 1 0 
0 0 0 1 0 0 0 0 
0 1 1 1 0 1 1 1 
0 0 0 0 0 1 2 0 
0 0 1 0 0 1 1 0 
1 0 1 1 0 1 0 0 
1 0 0 1 0 0 0 0 
